WWWWWWWWWWWWWWWWWWWWWWWWWWWWWWWWWWWWWWWWWWWWWWWWWWWWWWWWWWWWWWWWWWWWWWWWWWWWWWWWWWWWWWWWWWWWWWWWWWWWWWWWWWWWWWWWWWWWWWWWWWWWWWWWWWWWWWWWWWWWWWWWWWWWWWWWWWWWWWWWWWWWWWWWWWWWWWWWWWWWWWWWWWWWWWWWWWWWWWWWWWWWWWWWWWWWWWWWWWWWWWWWWWWWWWWWWWWWWWWWWWWWWWWWWWWWWWWWWWWWWWWWWWWWWWWWWWWWWWWWWWWWWWWWWWWWWWWWWWWWWWWWWWWWWWWWWWWWWWWW
W                                                                                                                                                              W                                                                                                                                                               W
W                                  B                                                                                                                           W                                                                                                                                                               W
W                                                                                                                                                              W                                                                                                                                                               W
W                                                                                                                                                              W                                                                                                                                                               W
W                                                                                                                                                              W                                                                                                                                                               W
W                                                                                                                                                              W                                                                                                                                               D               W
W                                                                                                                                                              W                                                                                                                                                               W
W                                                                                                                                                              W                                                                                                                                                               W
W                                                                                                                                                              W                                                                     K                                                                                         W
W                                                                                                                                                              W                                                                                                                                                               W
W                                                                                                                                                              W                                                                                                                                                               W
W                                                                                                                                                              W                                                                                                                                                               W
W                                                                                                                                                              W                                                                                                                                                               W
W                                                                                                                                                              W                                                                                                                                                               W
W                                                                                                                                                              W                       B                                                                                                                                       W
W                                                                                                                                                              W                                                               WWWWWWWWWWWWWWWWWWWW                                                                            W
W                                                                                                                                                              W                                                                                  W                                                                            W
W                                                                                                                                                              W                                                                                  W                                                                            W
W                                                                                                                                                              W                                                                                  W                                                                            W
W                                                                                                                                                              W                                                                                  WWWWWWWWWWWWWWWWW                          WWWWWWWWWWWWWWWWWWWWWWWWWWWWWWWWWWW
W                                                                                                                                                              W                                                                                                                                                               W
W                                                                                                                                                                                                                                                                                                                              W
W                                                                                                                                                                                                                                                                                                                              W
W                                                                                                              WWWWWWWWWWWWWWWWWWWWWWWW                                                                                                                                                                                        W
W                                           X                                                                  W                                                                                                                                                                                                               W
W                            WWWWWWWWWWWWWWWWWWWWWWWWWWWWWWWWWWWWWWWWWWWWWWWWWWWWWWW                           W                                                                                                                                                                                                               W
W                                                                                                              W                                                                                                                                                                                                               W
W                                                                                                              W                                                                                                                                                                                                               W
W                                                                                                              W                                                                                                                                        P                                                                      W
W                                                                                                              W                                                                                                                                                                                                               W
W                                                                                                              W                                                                                                                                                                                                               W
W                                                                                                              W                                                                                                                                                                                                               W
W                                                                                                              W                                                                                                                                                                                                               W
W                                                                                                              W                                                                                                                                                                                                               W
W                                                                                                              W                                                                                                                                                                                                               W
W                                                                                                              W                                                                                                                                                                                                               W
W                                                                                                              W                                                                                                                                                                                                               W
W                                                                                           FFFFFFFFFFFFFF     W                                                                                                                                                                                                               W
W                                                                                                              W                                                                                                                                                                                                               W
W                                                                                                              W                                                                                                                                                                                                               W
W                                                                                                              W                                                                                                                                                                                                               W
W                                                                                                              W                                      WWWWWWWWWWWWWWWWWWWW                                                                                                                                                     W
W   FFFFFFFFFFFFFF                                                                                             W                                                                                                                                                             FFFFFFFFFFFFF                                     W
W                   WWWWWWWWWWWWWWWWWWWWWWWWWWWWWWWWWWW                                                        W                                                                                                                                    WWWWWWWWWWWWWWWWWWWWW                                                      W
W                                                                                         M                    W                                                                                                                                                                                                               W
W                                                                                                              W                                     G                                                                                                              G                               WWWWWWWWWWWWWWWWWWWWWWW    W
W                                                                                                              W                                                                                                                                                                                                               W
W                                                                                                              W                                                                                                                                                                                                               W
W                                                                                                              W                                                                                                                                                                                                               W
W                                                                                                              W                                                                                                                                                                                                               W
W                                                                                                              W                                                                                                                                                                                                               W
W                                                                                                              W                                                                                                                                                                                                               W
W                                                                                                              W                                                                                                                                                                                                               W
W                                                                                                              W                                                                                                                                                                                                               W
W                                                                                                              W                                                                                                                                                                                                               W
W                                                                                                              W                                                                                                                                                                                                               W
W                                                                                                              W                                                                                                                                                                                                               W
W                                                                                                              W                                                                                                                  FFFFFFFFFFFFFF                                                                               W
W                                                                 FFFFFFFFFFFFFFF                              W                                                                               X                                                                                                                               W
WWWWWWWWWWWWWWWWWWWWWWWWWWWWWWWWWWWWWWWWWWWWWWWWWWWWWWWWWWWWWWWWWWWWWWWWWWWWWWWWWWWWWWWWWWWWWWWWWWWWWWWWWWWWWWWWWWWWWWWWWWWWWWWWWWWWWWWWWWWWWWWWWWWWWWWWWWWWWWWWWWWWWWWWWWWWWWWWWWWWWWWWWWWWWWWWWWWWWWWWWWWWWWWWWWWWWWWWWWWWWWWWWWWWWWWWWWWWWWWWWWWWWWWWWWWWWWWWWWWWWWWWWWWWWWWWWWWWWWWWWWWWWWWWWWWWWWWWWWWWWWWWWWWWWWWWWWWWWWWW